1111111111
1000000001
1111000001
1000000001
1000000001
1000000001
1000000001
1010100001
1010100011
1111111111