111111111111111177777777
100000000000000070000007
101000000000000000000007
102000000000000000000007
103000000000000070000007
101000055555555577077777
105000050505050570007771
106000050000000570000008
107000000000000000007771
108000050000000570000008
100000050000000570007771
100000055550555577777771
666666666660666666666666
800000000000000000000001
666666066660666666666666
111111011160622222223333
100000000160620000020002
100000000000620050020002
100000000160620000022022
106060000160000050000002
100500000160620000022022
106060000160620050020002
100000000160620000020002
111111111111122222233333