111111111111111111111111
100000000000000000000001
100000000000000000000001
100000000000000000000001
100000222220000202020001
100000200020000000000001
100000200020000200020001
100000200020000000000001
100000220220000202020001
100000000000000000000001
100000000000000000000001
100000000000000000000001
100000000000000000000001
100000000000000000000001
100000000000000000000001
100000000000000000000001
122222222000000000000001
120200002000000000000001
120000002000000000000001
120200002000000000000001
120222222000000000000001
120000000000000000000001
122222222000000000000001
111111111111111111111111