111111111111111111111111
100000000000000010000001
101000000000000000000001
100000000000000000000001
100000000000000010000001
101000012345678111011111
101000010101010110001111
101000010000000110000001
101000000000000000001111
101000010000000110000001
100000010000000110001111
100000011110111111111111
111111111110111111111111
100000000000000000000001
111111011110111111111111
111111011110100000000000
100000000110100000000000
100000000000100010000000
100000000110100000000000
101010000110000010000000
100100000110100000000000
101010000110100010000000
100000000110100000000000
111111111111100000000000